R 1920 1080
NO ./purplestone.xpm
SO ./bluestone.xpm
WE ./redbrick.xpm
EA ./wood.xpm
S ./barrel.xpm

C 100, 30, 0
F 100, 100, 245

1111111111111
1000000000001
1000000000001
1000000000001
1002002000001
1111111000001
1W00000000001
1000000000001
1111111111111
