R 1600 900
NO ./purplestone.xpm
SO ./bluestone.xpm
WE ./redbrick.xpm
EA ./wood.xpm
S ./barrel.xpm

C 100, 30, 0
F 100, 100, 0

11111111111111111111111111
12222202222000000000222221
12222200000011222220222221
11111111111111111110111111
12222202222200222220222221
12222200000011222220222221
11111111111111111110111111
12222202222200222220222221
12222200000000000000222221
12220N02222211111111111111
10000000000011
10000000000011
11111111111111
