R 1920 1080
NO ./path_to_the_north_texture
SO ./path_to_the_§south_texture
WE ./path_to_the_west_texture
EA ./path_to_the_east_texture
S ./path_to_the_sprite_texture

C 100, 30,0
F 100, 100, 245

        1111111111111111111111111
        1000000000110000000000001
        1011000001110000002000001
        1001000000000000000000001
111111111011000001110000000000001
100000000011000001110111111111111
111101111111110111000000100011111
11110111111111011101010010000001
110000001101010111000000100011111
10002000000000000000000000001
10000000000000001101010010001
11000001110101011111011110W01
11110111 1110101 101111010001
11111111 1111111 111111111111
