R 1600 900
NO ./purplestone.xpm
SO ./bluestone.xpm
WE ./redbrick.xpm
EA ./wood.xpm
S ./barrel.xpm

C 100, 30, 0
F 100, 100, 0

11111111111111
10000000000001
10000020000001
10020000000001
10020200200011
10222000000011
10000000000001
1000000N000011
10000000000011
11111111111111
