R 1920 1080
NO ./purplestone.xpm
SO ./bluestone.xpm
WE ./redbrick.xpm
EA ./wood.xpm
S ./barrel.xpm

C 100, 30, 0
F 100, 100, 245

1111111111111
1222220222221
1222220222221
1222220222221
1222220222221
1220000000221
1220001000221
1220000000221
1222000222221
1N00000000001
1111111111111

