R 1920 1080
NO ./purplestone.xpm
SO ./bluestone.xpm
WE ./redbrick.xpm
EA ./wood.xpm
S ./barrel.xpm

C 100, 30, 0
F 100, 100, 245

        1111111111111111111111111
        1000000000110000000000001
        1011000001110000002000001
        1001000000000000000000001
111111111011000001110000000000001
100000000011000001110111111111111
111101111111110111000000100011111
111101111111110111010100102000001
110000001101010111000000100011111
10002000000000000000000000001
10000000000000001101010010001
11000001110101011111011110W01
11110111 1110101 101111010001
11111111 1111111 111111111111
